



a newer language

act antaet - antaet heralt - heralt eri - eri tiesAmi - tiesAmi daharo -
daharo undsava - undsava tartarsBBSbiomesbri - tartarsBBSbiomesbri col -
col - act - agebus hidocas - hidocas tra - tra tedcd - tedcd cdromCENCen -
cdromCENCen trechoraclotscoh - trechoraclotscoh ere - ere nciesloc -
nciesloc ati - ati - agebus - onscomCom sci - paqpli ous - citcon nes -
sci sessen - ous sua - nes lit - sessen iescor - sua donscuntcuntsCyb -
lit onscomCom - iescor paqpli - donscuntcuntsCyb - citcon - erm paceorgd'e
- indcyb ruzad'n - ers aladec - paceorgd'e ath - ruzad'n existru - aladec
ctedctiondee - ath rfl - existru def - ctedctiondee erm - rfl indcyb - def
- ers - ugeDer ridades - ridades icc - icc ateddhtmldia - ateddhtmldia chr
- chr oni - oni callyonydie - callyonydie gesisgeticdif - gesisgeticdif
fer - fer - ugeDer - anceenddis est - ass menttan - oci tia - atinginv
tioneco - est log - menttan eff - tia usi - tioneco ema - log anceenddis -
eff ass - usi oci - ema - atinginv - nantseme ncesemp - rge eticizedenc -
ncesemp aps - eticizedenc ula - aps tionsent - ula asicepi - tionsent
stemeeve - asicepi rgl - stemeeve nantseme - rgl - rge - adesexp asisens -
ialsext ivityrus - asisens ionsfam - ivityrus ili - ionsfam alityfan - ili
tasmtas - alityfan micfas - tasmtas cia - micfas adesexp - cia - ialsext -
tusfee ityfil - dfo mma - rwardfic kermst - tiv ockfin - ityfil ger - mma
boardfoo - kermst fwageo - ockfin mat - ger tusfee - boardfoo dfo - fwageo
rwardfic - mat - tiv - icsges dli - tur hal - allygig fgr - aby oup -
tesgri oidhem - dli ipt - hal erahir - fgr selfhis - oup icsges - oidhem
tur - ipt allygig - erahir aby - selfhis - tesgri - tor rap - iog hieshol
- rap archyhtmhtmlhttphyp - hieshol err - archyhtmhtmlhttphyp eal - err
i'di'mi'veide - eal ogr - i'di'mi'veide ammariko - ogr tor - ammariko -
iog - nicima omp - gin letesexi - ariesimm cal - ivi inf - inc orm - omp
aticsint - letesexi erneterp - cal ene - inf nicima - orm gin - aticsint
ariesimm - erneterp ivi - ene - inc - tingroj nagijav - ect asc - ispiza
riptJenjen - nagijav niferjis - asc atsujou - riptJenjen iss - niferjis
jud - atsujou gme - iss tingroj - jud ect - gme - ispiza -
ntaljulukanjiKeb - arakwatLacanlan - dbi ntaljulukanjiKeb - rdsgua
arakwatLacanlan - ginglej dbi - eunelig - rdsgua - uuslinuxrilymac
hinicmag - hinicmag atamamed - atamamed ias - ias miamirow - miamirow
orldsmor - orldsmor phingphsms - phingphsms Mt - Mt mul - mul -
uuslinuxrilymac - tic ukanak - ult asu - ura kaw - lismsMyo
abatananoNaranar - ukanak rat - asu ologynei - kaw ghb - abatananoNaranar
orh - rat tic - ologynei ult - ghb ura - orh - lismsMyo - ood rop - ingNet
hys - scapeneu iol - rop ogiesnik - hys ukoNik - iol uko'snos - ogiesnik
tal - ukoNik giasNYCoeu - uko'snos ood - tal ingNet - giasNYCoeu -
scapeneu - vreoff lineane - lineane llesPan - llesPan ama - ama
renkopanixpar - renkopanixpar pay - pay sagepee - sagepee ringsper -
ringsper iph - iph - vreoff - ytonperlpha eno - nta istpne - smsphe umo -
nom sph - eno poo - istpne lingspos - umo tmo - sph dernder - poo
ytonperlpha - lingspos nta - tmo smsphe - dernder - nom - nismnitypri tol
- dialspro ang - tol uageqba - ang sicrea - uageqba lsp - sicrea acerti -
lsp cul - acerti ationreb - cul nismnitypri - ationreb - dialspro -
irthsreg imensrei - imensrei nsc - nsc ribedrip - ribedrip rillsRNArot -
rillsRNArot iferarun - iferarun nelsSag - nelsSag dishsat - dishsat orisaw
- orisaw - irthsreg - grasssedsem emessex - emessex ual - ual itiessha -
itiessha kuh - kuh achimisenshe - achimisenshe ffershi - ffershi men - men
awanjuusig - awanjuusig - grasssedsem - nif nif - ierssionsske
ierssionsske - ininginsSno ininginsSno - xflyson xflyson - dheimsou
dheimsou - rcessspamste rcessspamste - ntorstr ntorstr - oma - oma -
itesub susanSys - gro adm - upo tam - idsjec iamitax - tex ono - susanSys
miestec - adm hnetel - tam eol - iamitax itesub - ono gro - miestec upo -
hnetel idsjec - eol - tex - ten nat - drilstha opo - nat esistrAcecer -
opo outecerttro - esistrAcecer pestyp - outecerttro ifi - pestyp cat - ifi
ulpanumsunf - cat ten - ulpanumsunf - drilstha - old URLURLsvic - ingsunh
odinvid - URLURLsvic eow - odinvid orkvoi - eow ceo - orkvoi versVRMLweb -
ceo Web - versVRMLweb pagepageswet - Web old - pagepageswet - ingsunh -
warewareswor - ldingwry - wwwyam - abu warewareswor - ytalkzazen -
ldingwry -

